11111111111111111111111111111
10000000000000000000000000001
10000000000000000000000000001
10000000000000000000000000001
10000000000000000000000000001
10000000000000000111111000001
10000000000000000111111000001
10000011111100000000000000001
10000011111100000000000000001
1000000P000000000000000000001
10111111000000000000011111001
10000000000000000000011111111
100000000000000C0110000000001
10000000011111111111110000001
10000001111111111111111EC0001
11111111111111111111111111111
